0,0,0,0,0,0,0,0,0,0,0,0,0,0,0
0,0,0,0,0,0,0,0,0,0,0,0,0,0,0
0,0,5,5,5,5,5,5,5,5,5,5,5,0,0
0,0,5,1,1,1,1,1,1,1,1,1,5,0,0
0,0,5,1,2,2,2,2,2,2,2,1,5,0,0
0,0,5,1,2,3,3,3,3,3,2,1,5,0,0
0,0,5,1,2,3,4,4,4,3,2,1,5,0,0
0,0,5,1,2,3,4,5,4,3,2,1,5,0,0
0,0,5,1,2,3,4,5,4,3,2,1,5,0,0
0,0,5,1,2,3,4,4,4,3,2,1,5,0,0
0,0,5,1,2,3,3,3,3,3,2,1,5,0,0
0,0,5,1,2,2,2,2,2,2,2,1,5,0,0
0,0,5,1,1,1,1,1,1,1,1,1,5,0,0
0,0,5,5,5,5,5,5,5,5,5,5,5,0,0
0,0,0,0,0,0,0,0,0,0,0,0,0,0,0
0,0,0,0,0,0,0,0,0,0,0,0,0,0,0
0,0,0,0,0,0,0,0,0,0,0,0,0,0,0
0,0,0,0,0,0,0,0,0,0,0,0,0,0,0
0,0,0,0,0,0,0,0,0,0,0,0,0,0,0
0,0,0,0,0,0,0,0,0,0,0,0,0,0,0
0,0,0,0,0,0,0,0,0,0,0,0,0,0,0
0,0,0,0,0,0,0,0,0,0,0,0,0,0,0
0,0,0,0,0,0,0,0,0,0,0,0,0,0,0
0,0,0,0,0,0,0,0,0,0,0,0,0,0,0
